#######
#ooooo#
###ooo#
  #ooo#
  #ooo#
###o###
#ooo#  
##oo###
 #oooo#
 ######
